Ремонт Apple iPod touch 5	OK	Ремонт цифровой техники -> Планшеты и телефоны
Ремонт планшета Digma iDsD10 3G	OK	Ремонт цифровой техники -> Планшеты и телефоны
Заменить дисплей айфон 5c	OK	Ремонт цифровой техники -> Планшеты и телефоны
Прошить Motorola XT910 (Razr Maxx)	OK	Ремонт цифровой техники -> Планшеты и телефоны
Ремонт телефона Philips S388	OK	Ремонт цифровой техники -> Планшеты и телефоны
Заменить треснувший экран на айфон 5	OK	Ремонт цифровой техники -> Планшеты и телефоны
Замена стекла (тача) Ipad 2	OK	Ремонт цифровой техники -> Планшеты и телефоны
Заменить стекло на iPhone 5S	OK	Ремонт цифровой техники -> Планшеты и телефоны
Ремонт телефона iPhone 5С	OK	Ремонт цифровой техники -> Планшеты и телефоны
Ремонт планшета Digma	OK	Ремонт цифровой техники -> Планшеты и телефоны
Отремонтировать телефон iphone 4 withe	OK	Ремонт цифровой техники -> Планшеты и телефоны
Ремонт телефона iPhone 4s	OK	Ремонт цифровой техники -> Планшеты и телефоны
Заменить стекло на iPhone 5s	OK	Ремонт цифровой техники -> Планшеты и телефоны
Ремонт планшета Samsung Galaxy tab.2	OK	Ремонт цифровой техники -> Планшеты и телефоны
Поменять дисплей и стекло на iphone 4	OK	Ремонт цифровой техники -> Планшеты и телефоны
Заменить сенсорное стекло на Iphone 5s	OK	Ремонт цифровой техники -> Планшеты и телефоны
Заменить стекло и дисплей на iPhone 5	OK	Ремонт цифровой техники -> Планшеты и телефоны
Ремонт телефона Sony Xperia Z 1	OK	Ремонт цифровой техники -> Планшеты и телефоны
Ремонта телефона iPhone 5S	OK	Ремонт цифровой техники -> Планшеты и телефоны
Ремонт телефона Nokia Asha 308	OK	Ремонт цифровой техники -> Планшеты и телефоны
Отремонтировать телефон Iphone 4s	OK	Ремонт цифровой техники -> Планшеты и телефоны
Ремонт телефона Lg Nexus 4/ e960	OK	Ремонт цифровой техники -> Планшеты и телефоны
Ремонт планшета ASUS К012	OK	Ремонт цифровой техники -> Планшеты и телефоны
Заменить стекло на iPhone 5c	OK	Ремонт цифровой техники -> Планшеты и телефоны
Заменить дисплей на IPad	OK	Ремонт цифровой техники -> Планшеты и телефоны
Ремонт планшета PocketBook SurfPad 2	OK	Ремонт цифровой техники -> Планшеты и телефоны
Заменить стекло на iPhone 6	OK	Ремонт цифровой техники -> Планшеты и телефоны
Отремонтировать ( поменять ) экран iPhone 5	OK	Ремонт цифровой техники -> Планшеты и телефоны
Ремонт телефона iPhone 4S	OK	Ремонт цифровой техники -> Планшеты и телефоны
Заменить экран и аккумулятор на iPhone 5	OK	Ремонт цифровой техники -> Планшеты и телефоны
Заменить стекло на iPad	OK	Ремонт цифровой техники -> Планшеты и телефоны
Ремонт телефона iPhone 5s	OK	Ремонт цифровой техники -> Планшеты и телефоны
Заменить аккумулятор в iPhone 5	OK	Ремонт цифровой техники -> Планшеты и телефоны
Ремонт планшета Prestigio	OK	Ремонт цифровой техники -> Планшеты и телефоны
Ремонт телефона 3 шт. в Щелково	OK	Ремонт цифровой техники -> Планшеты и телефоны
Ремонт планшеты Lenovo Yoga	OK	Ремонт цифровой техники -> Планшеты и телефоны
Ремонт сотового телефона iPhone 6	OK	Ремонт цифровой техники -> Планшеты и телефоны
Ремонт китайского телефона Iphone 6	OK	Ремонт цифровой техники -> Планшеты и телефоны
Замена разъема зарядки на планшете	OK	Ремонт цифровой техники -> Планшеты и телефоны
Ремонт двух iPhone S	OK	Ремонт цифровой техники -> Планшеты и телефоны
Ремонт телефона HTC One	OK	Ремонт цифровой техники -> Планшеты и телефоны
Перепрошить телефона Lenovo k900	OK	Ремонт цифровой техники -> Планшеты и телефоны
Ремонт телефона HTC One M7	OK	Ремонт цифровой техники -> Планшеты и телефоны
Отремонтировать два iPhone 6 и 5S	OK	Ремонт цифровой техники -> Планшеты и телефоны
Отремонтировать телефон: Заменить экран и батарею на iphone 4	BAD weak-match	Ремонт цифровой техники -> Планшеты и телефоны
	Ремонт цифровой техники -> Планшеты и телефоны = 0.788	Ремонт цифровой техники = 0.212
	ремонт(1;1.0;отремонтирова), замена(1;1.0;замен), гаджет(1;1.0;телефон), электроника(1;1.0;телефон), телефон(1;1.0;телефон), экран(1;1.0;экра), гаджет(1;1.0;iphon)
Отремонтировать телефон Samsung Galaxy S4 (матрицу + стекло)	OK	Ремонт цифровой техники -> Планшеты и телефоны
Ремонт телефона iPhone 5S	OK	Ремонт цифровой техники -> Планшеты и телефоны
Ремонт планшетов HP Slate 7 и Asus Fonepad HD 7 ME372CG	BAD weak-match	Ремонт цифровой техники -> Планшеты и телефоны
	Ремонт цифровой техники -> Планшеты и телефоны = 0.907	Ремонт цифровой техники = 0.093
	гаджет(1;1.0;планшет), электроника(1;1.0;планшет), производитель электроники(1;0.3;hp), производитель планшетов(1;0.3;hp), ремонт(1;1.0;ремонт), производитель электроники(1;0.3;asus), производитель планшетов(1;0.3;asus)
Ремонт сотового телефона iPhone 6 в Клину	OK	Ремонт цифровой техники -> Планшеты и телефоны
Замена стекла и корпуса Iphone	OK	Ремонт цифровой техники -> Планшеты и телефоны
Ремонт iPhone	OK	Ремонт цифровой техники -> Планшеты и телефоны
Ремонт телефона Xperia Z	OK	Ремонт цифровой техники -> Планшеты и телефоны
Ремонт планшета Apple IPad mini	OK	Ремонт цифровой техники -> Планшеты и телефоны
Заменить стекло iPhone 5	OK	Ремонт цифровой техники -> Планшеты и телефоны
Поменять стекло на iPhone 5	OK	Ремонт цифровой техники -> Планшеты и телефоны
Ремонт телефона Sony Xperia SP	OK	Ремонт цифровой техники -> Планшеты и телефоны
Купить и поменять дисплей Sony Xperia Z3	BAD weak-match	Ремонт цифровой техники -> Планшеты и телефоны
	Ремонт цифровой техники -> Планшеты и телефоны = 0.735	Ремонт цифровой техники = 0.265
	замена(1;1.0;поменя), производитель электроники(1;0.3;son), производитель телефонов(1;0.3;son), производитель аудио(1;0.3;son), производитель тв(1;0.3;son), производитель планшетов(1;0.3;son), экран(1;1.0;диспл), купить(1;1.0;куп)
Заменить тачскрин на Sony c2305	BAD weak-match	Ремонт цифровой техники -> Планшеты и телефоны
	Ремонт цифровой техники -> Планшеты и телефоны = 0.581	Ремонт цифровой техники = 0.419
	замена(1;1.0;замен), экран(1;1.0;тачскрин), производитель электроники(1;0.3;son), производитель телефонов(1;0.3;son), производитель аудио(1;0.3;son), производитель тв(1;0.3;son), производитель планшетов(1;0.3;son)
Ремонт утопленного iPhone 6	OK	Ремонт цифровой техники -> Планшеты и телефоны
Ремонт планшета Lenovo TAB A8	BAD weak-match	Ремонт цифровой техники -> Планшеты и телефоны
	Ремонт цифровой техники -> Планшеты и телефоны = 0.907	Ремонт цифровой техники = 0.093
	производитель электроники(1;0.3;lenov), производитель планшетов(1;0.3;lenov), ремонт(1;1.0;ремонт), гаджет(1;1.0;планшет), электроника(1;1.0;планшет)
Заменить дисплейный модуль Sony Z3	BAD weak-match	Ремонт цифровой техники -> Планшеты и телефоны
	Ремонт цифровой техники -> Планшеты и телефоны = 0.581	Ремонт цифровой техники = 0.419
	замена(1;1.0;замен), экран(1;1.0;дисплейн модул), производитель электроники(1;0.3;son), производитель телефонов(1;0.3;son), производитель аудио(1;0.3;son), производитель тв(1;0.3;son), производитель планшетов(1;0.3;son)
Отремонтировать домашний радио телефон	OK	Ремонт цифровой техники -> Планшеты и телефоны
Заменить переднее стекло и батарейку Apple iPhone 5s	OK	Ремонт цифровой техники -> Планшеты и телефоны
Замена гнезда зарядки на телефона THL W300	OK	Ремонт цифровой техники -> Планшеты и телефоны
Отремонтировать телефон Samsung Galaxy S 4	OK	Ремонт цифровой техники -> Планшеты и телефоны
Ремонт IPhone 6	OK	Ремонт цифровой техники -> Планшеты и телефоны
Ремонт IPhone 4	OK	Ремонт цифровой техники -> Планшеты и телефоны
Прошить iPad mini	OK	Ремонт цифровой техники -> Планшеты и телефоны
Отремонтировать домашний радио телефон	OK	Ремонт цифровой техники -> Планшеты и телефоны
Заменить стекло Samsung N7100 Note 2	BAD weak-match	Ремонт цифровой техники -> Планшеты и телефоны
	Ремонт цифровой техники -> Планшеты и телефоны = 0.746	Ремонт цифровой техники = 0.245	Компьютерная помощь -> Ремонт компьютеров и ноутбуков = 0.009
	производитель электроники(1;0.3;samsung), производитель аудио(1;0.3;samsung), производитель тв(1;0.3;samsung), производитель планшетов(1;0.3;samsung), замена(1;1.0;замен), стекло(1;1.0;стекл)
Ремонт Apple iPhone 4	OK	Ремонт цифровой техники -> Планшеты и телефоны
Ремонт Apple iPhone 5	OK	Ремонт цифровой техники -> Планшеты и телефоны
Ремонт телефона Sony Experia Z3	OK	Ремонт цифровой техники -> Планшеты и телефоны
Ремонт экрана телефона	BAD weak-match	Ремонт цифровой техники -> Планшеты и телефоны
	Ремонт цифровой техники -> Планшеты и телефоны = 0.879	Ремонт цифровой техники = 0.121
	гаджет(1;1.0;телефон), электроника(1;1.0;телефон), телефон(1;1.0;телефон), ремонт(1;1.0;ремонт), экран(1;1.0;экра)
Ремонт телефона IPhone 4	OK	Ремонт цифровой техники -> Планшеты и телефоны
Заменить батарею на iPhone 5	OK	Ремонт цифровой техники -> Планшеты и телефоны
Ремонт телефона HTC Desire 601	OK	Ремонт цифровой техники -> Планшеты и телефоны
Ремонт динамика телефона Lenovo S860	OK	Ремонт цифровой техники -> Планшеты и телефоны
Ремонт планшета ASUS Fonepad 7 FE170CG	BAD weak-match	Ремонт цифровой техники -> Планшеты и телефоны
	Ремонт цифровой техники -> Планшеты и телефоны = 0.907	Ремонт цифровой техники = 0.093
	ремонт(1;1.0;ремонт), производитель электроники(1;0.3;asus), производитель планшетов(1;0.3;asus), гаджет(1;1.0;планшет), электроника(1;1.0;планшет)
Ремонт телефона Highscreen Zera S	OK	Ремонт цифровой техники -> Планшеты и телефоны
Заменить Экран iphone 5c	OK	Ремонт цифровой техники -> Планшеты и телефоны
Ремонт iPhone 6	OK	Ремонт цифровой техники -> Планшеты и телефоны
Ремонт iPhone 5	OK	Ремонт цифровой техники -> Планшеты и телефоны
Ремонт телефона Samsung Galaxy 4s	OK	Ремонт цифровой техники -> Планшеты и телефоны
Ремонт телефона Sony Xperia Z1	OK	Ремонт цифровой техники -> Планшеты и телефоны
Ремонт телефона Sony Xperia Z3	OK	Ремонт цифровой техники -> Планшеты и телефоны
Ремонт планшета	OK	Ремонт цифровой техники -> Планшеты и телефоны
Замена дисплея Sony Xperia Z C6603 black	BAD weak-match	Ремонт цифровой техники -> Планшеты и телефоны
	Ремонт цифровой техники -> Планшеты и телефоны = 0.901	Компьютерная помощь -> Ремонт компьютеров и ноутбуков = 0.058	Ремонт цифровой техники = 0.041
	замена(1;1.0;зам), производитель электроники(1;0.3;son), производитель телефонов(1;0.3;son), производитель аудио(1;0.3;son), производитель тв(1;0.3;son), производитель планшетов(1;0.3;son)
Ремонт телефона	OK	Ремонт цифровой техники -> Планшеты и телефоны
Мастер на ремонт телефонов и планшетов	OK	Ремонт цифровой техники -> Планшеты и телефоны
Поменять разбитое стекло на iphope 5 (или 5s)	BAD weak-match	Ремонт цифровой техники -> Планшеты и телефоны
	Ремонт цифровой техники -> Планшеты и телефоны = 0.746	Ремонт цифровой техники = 0.244	Компьютерная помощь -> Ремонт компьютеров и ноутбуков = 0.006	Фото- и видео-услуги = 0.004
	замена(1;1.0;поменя), стекло(1;1.0;стекл), сломалось(1;1.0;разбит)
Ремонт телефона Samsung	OK	Ремонт цифровой техники -> Планшеты и телефоны
Ремонт Apple iPhone 4S	OK	Ремонт цифровой техники -> Планшеты и телефоны
Заменить стекло на айпед 1	OK	Ремонт цифровой техники -> Планшеты и телефоны
Ремонт телефона Apple iPhone 5S	OK	Ремонт цифровой техники -> Планшеты и телефоны
Замена разъема зарядки планшета ASUS NEXUS 7	BAD weak-match	Ремонт цифровой техники -> Планшеты и телефоны
	Ремонт цифровой техники -> Планшеты и телефоны = 0.803	Ремонт цифровой техники = 0.197
	замена(1;1.0;зам), производитель электроники(1;0.3;asus), производитель планшетов(1;0.3;asus), зарядное устройство(1;1.0;зарядк), гаджет(1;1.0;планшет), электроника(1;1.0;планшет)
Ремонт телефона Nokia Lumia 820	OK	Ремонт цифровой техники -> Планшеты и телефоны
Ремонт Apple iPod nano 6	OK	Ремонт цифровой техники -> Планшеты и телефоны
Ремонт Iphone 5s	OK	Ремонт цифровой техники -> Планшеты и телефоны
Ремонт телефона Lenovo P780	OK	Ремонт цифровой техники -> Планшеты и телефоны
Починить 5 IPhone	OK	Ремонт цифровой техники -> Планшеты и телефоны
Ремонт 5 iPhone	OK	Ремонт цифровой техники -> Планшеты и телефоны
Ремонт телефона HTC ONE	OK	Ремонт цифровой техники -> Планшеты и телефоны
Ремонт и прошивка iPhone 3GS	OK	Ремонт цифровой техники -> Планшеты и телефоны
Заменить экран на Apple iPhone 5	OK	Ремонт цифровой техники -> Планшеты и телефоны
Ремонт телефона HTC Butterfly X920e	OK	Ремонт цифровой техники -> Планшеты и телефоны
Ремонт планшета MegaFon Login 3T	OK	Ремонт цифровой техники -> Планшеты и телефоны
Поменять экран смартфона Samsung SIII mini	BAD weak-match	Ремонт цифровой техники -> Планшеты и телефоны
	Ремонт цифровой техники -> Планшеты и телефоны = 0.778	Ремонт цифровой техники = 0.222
	замена(1;1.0;поменя), гаджет(1;1.0;смартфон), электроника(1;1.0;смартфон), телефон(1;1.0;смартфон), производитель электроники(1;0.3;samsung), производитель аудио(1;0.3;samsung), производитель тв(1;0.3;samsung), производитель планшетов(1;0.3;samsung), экран(1;1.0;экра), производитель аудио(1;0.3;min), производитель часов(1;0.3;min)
Заменить дисплей на айфон 5	OK	Ремонт цифровой техники -> Планшеты и телефоны
Отремонтировать телефон iPhone 5	OK	Ремонт цифровой техники -> Планшеты и телефоны
Отремонтировать телефон	OK	Ремонт цифровой техники -> Планшеты и телефоны
Ремонт экрана iPhone 4S	OK	Ремонт цифровой техники -> Планшеты и телефоны
Отремонтировать iPhone 4	OK	Ремонт цифровой техники -> Планшеты и телефоны
Ремонт планшета iPad 2	OK	Ремонт цифровой техники -> Планшеты и телефоны
Ремонт смартфона	OK	Ремонт цифровой техники -> Планшеты и телефоны
Ремонт планшета Samsung Galaxy Tab 2	OK	Ремонт цифровой техники -> Планшеты и телефоны
Собрать из двух один iPad4	BAD weak-match	Ремонт цифровой техники -> Планшеты и телефоны
	Ремонт цифровой техники -> Планшеты и телефоны = 0.939	Фото- и видео-услуги = 0.061
	смонтировать-собрать(1;1.0;собра), гаджет(1;1.0;ipad4)
Планшет Irbis TG 97. Отходит usb-вход	BAD weak-match	Ремонт цифровой техники -> Планшеты и телефоны
	Ремонт цифровой техники -> Планшеты и телефоны = 0.864	Ремонт цифровой техники = 0.136
	запчасти(1;1.0;усб-вход), производитель телефонов(1;0.3;irbis), производитель тв(1;0.3;irbis), производитель планшетов(1;0.3;irbis), гаджет(1;1.0;планшет), электроника(1;1.0;планшет)
Поменять корпус на iPhone 5c	OK	Ремонт цифровой техники -> Планшеты и телефоны
Замена стекла на планшете Acer Iconia A3-A11	BAD weak-match	Ремонт цифровой техники -> Планшеты и телефоны
	Ремонт цифровой техники -> Планшеты и телефоны = 0.899	Ремонт цифровой техники = 0.101
	замена(1;1.0;зам), производитель электроники(1;0.3;acer), производитель планшетов(1;0.3;acer), стекло(1;1.0;стекл), производитель аудио(1;0.3;icon), гаджет(1;1.0;планшет), электроника(1;1.0;планшет)
Отремонтировать планшет	OK	Ремонт цифровой техники -> Планшеты и телефоны
Отремонтировать iPhone 4S Белый	OK	Ремонт цифровой техники -> Планшеты и телефоны
Заменить батарейку на Iphone 4S	OK	Ремонт цифровой техники -> Планшеты и телефоны
Ремонт iPhone 4G	OK	Ремонт цифровой техники -> Планшеты и телефоны
Ремонт телефона iPhone 6	OK	Ремонт цифровой техники -> Планшеты и телефоны
Ремонт телефона iPhone 5	OK	Ремонт цифровой техники -> Планшеты и телефоны
Замена стекла экрана IPhone 6	OK	Ремонт цифровой техники -> Планшеты и телефоны
Ремонт телефона Samsyng galaxy s3 mini	OK	Ремонт цифровой техники -> Планшеты и телефоны
Заменить экран на iPhone 5 черный	OK	Ремонт цифровой техники -> Планшеты и телефоны
Отремонтировать iPhone 4s	OK	Ремонт цифровой техники -> Планшеты и телефоны
Ремонт iPhone 4S	OK	Ремонт цифровой техники -> Планшеты и телефоны
Ремонт телефона Sony Xperia z 3 compact	OK	Ремонт цифровой техники -> Планшеты и телефоны
Ремонт сотового телефона Sony Ericsson MT15i	OK	Ремонт цифровой техники -> Планшеты и телефоны
Замена стекла Samsung Galaxy Tab 3 10.1	BAD weak-match	Ремонт цифровой техники -> Планшеты и телефоны
	Ремонт цифровой техники -> Планшеты и телефоны = 0.746	Ремонт цифровой техники = 0.245	Компьютерная помощь -> Ремонт компьютеров и ноутбуков = 0.009
	замена(1;1.0;зам), производитель электроники(1;0.3;samsung), производитель аудио(1;0.3;samsung), производитель тв(1;0.3;samsung), производитель планшетов(1;0.3;samsung), стекло(1;1.0;стекл)
Ремонт двух мобильных телефонов Nokia Lumia 620 и Sony Xperia Z	OK	Ремонт цифровой техники -> Планшеты и телефоны
Ремонт экрана телефона HTC Sensation Z710e	OK	Ремонт цифровой техники -> Планшеты и телефоны
Ремонт телефона iPhone 6 + Clone	OK	Ремонт цифровой техники -> Планшеты и телефоны
Ремонт iPhone 5c	OK	Ремонт цифровой техники -> Планшеты и телефоны
Замена гнезда зарядки на телефона Lenovo K910 Vibe Z	OK	Ремонт цифровой техники -> Планшеты и телефоны
Ремонт 2-х планшетов	OK	Ремонт цифровой техники -> Планшеты и телефоны
Ремонт планшета asus k012	BAD weak-match	Ремонт цифровой техники -> Планшеты и телефоны
	Ремонт цифровой техники -> Планшеты и телефоны = 0.907	Ремонт цифровой техники = 0.093
	ремонт(1;1.0;ремонт), производитель электроники(1;0.3;asus), производитель планшетов(1;0.3;asus), гаджет(1;1.0;планшет), электроника(1;1.0;планшет)
Заменить стекло на планшете Asus	BAD weak-match	Ремонт цифровой техники -> Планшеты и телефоны
	Ремонт цифровой техники -> Планшеты и телефоны = 0.795	Ремонт цифровой техники = 0.205
	замена(1;1.0;замен), стекло(1;1.0;стекл), производитель электроники(1;0.3;asus), производитель планшетов(1;0.3;asus), гаджет(1;1.0;планшет), электроника(1;1.0;планшет)
Ремонт телефона iРhone 6	OK	Ремонт цифровой техники -> Планшеты и телефоны
Ремонт планшета lenovo s6000	BAD weak-match	Ремонт цифровой техники -> Планшеты и телефоны
	Ремонт цифровой техники -> Планшеты и телефоны = 0.907	Ремонт цифровой техники = 0.093
	производитель электроники(1;0.3;lenov), производитель планшетов(1;0.3;lenov), ремонт(1;1.0;ремонт), гаджет(1;1.0;планшет), электроника(1;1.0;планшет)
Ремонт iPhone 5s	OK	Ремонт цифровой техники -> Планшеты и телефоны
Ремонт телефона Apple iPhone 5	OK	Ремонт цифровой техники -> Планшеты и телефоны
Заменить батарею на iPhone 5s	OK	Ремонт цифровой техники -> Планшеты и телефоны
Ремонт телефона Iphone 4s	OK	Ремонт цифровой техники -> Планшеты и телефоны
Прошивка телефона iPhone 5	OK	Ремонт цифровой техники -> Планшеты и телефоны
Ремонт телефона Samsung Galaxy S III I9300	OK	Ремонт цифровой техники -> Планшеты и телефоны
Заменить разбитый дисплей Iphone 5	OK	Ремонт цифровой техники -> Планшеты и телефоны
Ремонт телефона Samsung GALAXY S4	OK	Ремонт цифровой техники -> Планшеты и телефоны
Ремонт телефона Iphone 5	OK	Ремонт цифровой техники -> Планшеты и телефоны
Замени экран iPhone 6	OK	Ремонт цифровой техники -> Планшеты и телефоны
Ремонт телефона Fly	OK	Ремонт цифровой техники -> Планшеты и телефоны
Прошить телефон через FlashTool	OK	Ремонт цифровой техники -> Планшеты и телефоны
Ремонт iPhone 5C	OK	Ремонт цифровой техники -> Планшеты и телефоны
Заменить стекло на iPhone5S	OK	Ремонт цифровой техники -> Планшеты и телефоны
Ремонт iPhone 5 в Алтуфьево	OK	Ремонт цифровой техники -> Планшеты и телефоны
Айфон отремонтировать	OK	Ремонт цифровой техники -> Планшеты и телефоны
Отремонтировать телефон Galaxy GT-I9500	OK	Ремонт цифровой техники -> Планшеты и телефоны
Ремонт телефона Sony Xperia TX	OK	Ремонт цифровой техники -> Планшеты и телефоны
Ремонт IPhone 5	OK	Ремонт цифровой техники -> Планшеты и телефоны
Ремонт Айфона 5	OK	Ремонт цифровой техники -> Планшеты и телефоны
Ремонт планшета prestigio multipad 5580c	OK	Ремонт цифровой техники -> Планшеты и телефоны
Ремонт планшета Texet TM-9767 3G	OK	Ремонт цифровой техники -> Планшеты и телефоны
Ремонт телефона Samsung Galaxy Grand 2	OK	Ремонт цифровой техники -> Планшеты и телефоны
Ремонт телефона Iphone 4S	OK	Ремонт цифровой техники -> Планшеты и телефоны
Ремонт экрана телефона iPhone	BAD weak-match	Ремонт цифровой техники -> Планшеты и телефоны
	Ремонт цифровой техники -> Планшеты и телефоны = 0.879	Ремонт цифровой техники = 0.121
	гаджет(1;1.0;телефон), электроника(1;1.0;телефон), телефон(1;1.0;телефон), ремонт(1;1.0;ремонт), экран(1;1.0;экра), гаджет(1;1.0;iphon)
Ремонт телефона iPhone 5 в Солнечногорске	OK	Ремонт цифровой техники -> Планшеты и телефоны
Ремонт телефона Nokia 625	OK	Ремонт цифровой техники -> Планшеты и телефоны
Ремонт телефона Samsung Galaxy Note 2	OK	Ремонт цифровой техники -> Планшеты и телефоны
Ремонт телефона Highscreen Thor	OK	Ремонт цифровой техники -> Планшеты и телефоны
Ремонт телефонов Samsung s3 в СВАО	OK	Ремонт цифровой техники -> Планшеты и телефоны
Ремонт планшета Asus Nexus 7	BAD weak-match	Ремонт цифровой техники -> Планшеты и телефоны
	Ремонт цифровой техники -> Планшеты и телефоны = 0.907	Ремонт цифровой техники = 0.093
	ремонт(1;1.0;ремонт), производитель электроники(1;0.3;asus), производитель планшетов(1;0.3;asus), гаджет(1;1.0;планшет), электроника(1;1.0;планшет)
Поменять стекло телефона iPhone 5s	OK	Ремонт цифровой техники -> Планшеты и телефоны
Ремонт сотового телефона Samsung	OK	Ремонт цифровой техники -> Планшеты и телефоны
Перепрошить телефон	OK	Ремонт цифровой техники -> Планшеты и телефоны
Ремонт телефона HTC One (М8)	OK	Ремонт цифровой техники -> Планшеты и телефоны
Ремонт телефона Samsung Galaxy S4	OK	Ремонт цифровой техники -> Планшеты и телефоны
Отремонтировать телефон iPhone 4S	OK	Ремонт цифровой техники -> Планшеты и телефоны
Отремонтировать планшет Samsung Tab 2 10.1	OK	Ремонт цифровой техники -> Планшеты и телефоны
Поменять экран на айфон 4	OK	Ремонт цифровой техники -> Планшеты и телефоны
Заменить дисплей на IPhone 5S	OK	Ремонт цифровой техники -> Планшеты и телефоны
Ремонт телефонов МТС	OK	Ремонт цифровой техники -> Планшеты и телефоны
Отремонтировать планшеты ( Зеленоград)	OK	Ремонт цифровой техники -> Планшеты и телефоны
iPhone 5: починить/почистить или заменить камеру	OK	Ремонт цифровой техники -> Планшеты и телефоны
Замена дисплея iPhone 4S белый	OK	Ремонт цифровой техники -> Планшеты и телефоны
Ремонт планшета Asus Nexus 2013 LTE	BAD weak-match	Ремонт цифровой техники -> Планшеты и телефоны
	Ремонт цифровой техники -> Планшеты и телефоны = 0.907	Ремонт цифровой техники = 0.093
	ремонт(1;1.0;ремонт), производитель электроники(1;0.3;asus), производитель планшетов(1;0.3;asus), гаджет(1;1.0;планшет), электроника(1;1.0;планшет)
Ремонт телефона iPhone 5 s	OK	Ремонт цифровой техники -> Планшеты и телефоны
Ремонт айфон 5s	OK	Ремонт цифровой техники -> Планшеты и телефоны
Не включается Huawei Mate 6.1	BAD weak-match	Ремонт цифровой техники -> Планшеты и телефоны
	Ремонт цифровой техники -> Планшеты и телефоны = 0.935	Фото- и видео-услуги = 0.065
	производитель телефонов(1;0.3;huaw), производитель смарт-часов(1;0.3;huaw), производитель планшетов(1;0.3;huaw)
Перепрошить планшет Asus Transformer Pad TF300TG	BAD weak-match	Ремонт цифровой техники -> Планшеты и телефоны
	Ремонт цифровой техники -> Планшеты и телефоны = 0.881	Ремонт цифровой техники = 0.119
	прошить(1;1.0;перепрош), производитель электроники(1;0.3;asus), производитель планшетов(1;0.3;asus), гаджет(1;1.0;планшет), электроника(1;1.0;планшет)
Ремонт смартфона MegaFon Login 2	OK	Ремонт цифровой техники -> Планшеты и телефоны
Заменить USB-порт (mini-USB) на планшете Digma	OK	Ремонт цифровой техники -> Планшеты и телефоны
Поменять стекло на ZTE Blade l2	BAD weak-match	Ремонт цифровой техники -> Планшеты и телефоны
	Ремонт цифровой техники -> Планшеты и телефоны = 0.894	Ремонт цифровой техники = 0.106
	замена(1;1.0;поменя), производитель электроники(1;0.3;zte), производитель телефонов(1;0.3;zte), производитель планшетов(1;0.3;zte), стекло(1;1.0;стекл)
Отремонтировать телефон HTC Desire V	OK	Ремонт цифровой техники -> Планшеты и телефоны
Заменить стекло IPad Air	OK	Ремонт цифровой техники -> Планшеты и телефоны
Ремонт телефона Sony Z1	OK	Ремонт цифровой техники -> Планшеты и телефоны
Ремонт телефона IPhone	OK	Ремонт цифровой техники -> Планшеты и телефоны
Ремонт телефона Apple iPhone 4S	OK	Ремонт цифровой техники -> Планшеты и телефоны
Заменить стекло на айпэд мини первого поколения	OK	Ремонт цифровой техники -> Планшеты и телефоны
Ремонт телефона Samsung Galaxy S5	OK	Ремонт цифровой техники -> Планшеты и телефоны
Ремонт сотового телефона iphone 6	OK	Ремонт цифровой техники -> Планшеты и телефоны
Ремонт сотового телефона Sony Xperia Z1	OK	Ремонт цифровой техники -> Планшеты и телефоны
Замена стекла на планшете Asus	BAD weak-match	Ремонт цифровой техники -> Планшеты и телефоны
	Ремонт цифровой техники -> Планшеты и телефоны = 0.795	Ремонт цифровой техники = 0.205
	замена(1;1.0;зам), стекло(1;1.0;стекл), производитель электроники(1;0.3;asus), производитель планшетов(1;0.3;asus), гаджет(1;1.0;планшет), электроника(1;1.0;планшет)
Ремонт телефона Samsung Galaxy S3	OK	Ремонт цифровой техники -> Планшеты и телефоны
Ремонт Apple IPHONE 5	OK	Ремонт цифровой техники -> Планшеты и телефоны
Ремонт экрана телефона Fly IQ4403	OK	Ремонт цифровой техники -> Планшеты и телефоны
Ремонт телефона ALCATEL ONE TOUCH 5036D	OK	Ремонт цифровой техники -> Планшеты и телефоны
Ремонт сотового телефона Lenovo S720	OK	Ремонт цифровой техники -> Планшеты и телефоны
Ремонт планшета Explay Informer 705	OK	Ремонт цифровой техники -> Планшеты и телефоны
Ремонт планшета Samsung	OK	Ремонт цифровой техники -> Планшеты и телефоны
Замена экрана и динамика iphone 4 белый	BAD weak-match	Ремонт цифровой техники -> Планшеты и телефоны
	Ремонт цифровой техники -> Планшеты и телефоны = 0.934	Ремонт цифровой техники -> Аудиотехника и системы = 0.066
	замена(1;1.0;зам), аудио(1;1.0;динамик), экран(1;1.0;экра), гаджет(1;1.0;iphon)



----------------------------------------------------------




----------------------------------------------------------




----------------------------------------------------------

Ремонт компьютера	OK	Компьютерная помощь -> Ремонт компьютеров и ноутбуков
Диагностика и ремонт ноутбука Samsung R528	OK	Компьютерная помощь -> Ремонт компьютеров и ноутбуков
Ремонт ноутбука Samsung NP530U3C-A02	OK	Компьютерная помощь -> Ремонт компьютеров и ноутбуков
Ремонт ноутбука Sony Vaio	OK	Компьютерная помощь -> Ремонт компьютеров и ноутбуков
Ремонт ноутбука ASUS K43S	OK	Компьютерная помощь -> Ремонт компьютеров и ноутбуков
Помочь настроить компьютер	OK	Компьютерная помощь -> Ремонт компьютеров и ноутбуков
Устранить неполадок на ноутбуке	OK	Компьютерная помощь -> Ремонт компьютеров и ноутбуков
Замена блока питания на системном блоке	BAD weak-match	Компьютерная помощь -> Ремонт компьютеров и ноутбуков
	Компьютерная помощь -> Ремонт компьютеров и ноутбуков = 0.781	Ремонт цифровой техники = 0.219
	замена(1;1.0;зам), компьютерные запчасти(1;1.0;системн блок), запчасти(1;1.0;блок питан)
Ремонт ноутбука HP G62-346NR	OK	Компьютерная помощь -> Ремонт компьютеров и ноутбуков
Диагностика и ремонт 2 ноутбуков	OK	Компьютерная помощь -> Ремонт компьютеров и ноутбуков
Чистка ноутбука	OK	Компьютерная помощь -> Ремонт компьютеров и ноутбуков
Отремонтировать ноутбуки	OK	Компьютерная помощь -> Ремонт компьютеров и ноутбуков
Починить ноутбук Asus	OK	Компьютерная помощь -> Ремонт компьютеров и ноутбуков
Ремонт ноутбука Acer Aspire V3-571G	OK	Компьютерная помощь -> Ремонт компьютеров и ноутбуков
Провести диагностику	BAD weak-match	Компьютерная помощь -> Ремонт компьютеров и ноутбуков
	Компьютерная помощь -> Ремонт компьютеров и ноутбуков = 0.905	Ремонт цифровой техники = 0.058	Фото- и видео-услуги = 0.036
	диагностика(1;1.0;диагностик), провести(1;1.0;провест)
Ремонт ноутбука MSi GX 60	OK	Компьютерная помощь -> Ремонт компьютеров и ноутбуков
Помочь починить компьютер	OK	Компьютерная помощь -> Ремонт компьютеров и ноутбуков
Ремонт компьютеров	OK	Компьютерная помощь -> Ремонт компьютеров и ноутбуков
Поменять клавиатуру ноутбука	OK	Компьютерная помощь -> Ремонт компьютеров и ноутбуков
Ремонт ноутбука HP	OK	Компьютерная помощь -> Ремонт компьютеров и ноутбуков
Ремонт ноутбука Lenovo g505s	OK	Компьютерная помощь -> Ремонт компьютеров и ноутбуков
Ремонт ноутбука	OK	Компьютерная помощь -> Ремонт компьютеров и ноутбуков
Отремонтировать ноутбук lenovo	OK	Компьютерная помощь -> Ремонт компьютеров и ноутбуков
Починить ноутбук	OK	Компьютерная помощь -> Ремонт компьютеров и ноутбуков
Восстановить жесткий диск ноутбука	OK	Компьютерная помощь -> Ремонт компьютеров и ноутбуков
Диагностика и устранение неисправности компьютера	OK	Компьютерная помощь -> Ремонт компьютеров и ноутбуков
Ремонт ноутбуков в Ногинске	OK	Компьютерная помощь -> Ремонт компьютеров и ноутбуков
Почистить ноутбук HP Compaq Presario 58	OK	Компьютерная помощь -> Ремонт компьютеров и ноутбуков
Отремонтировать ноутбук Packard bell	OK	Компьютерная помощь -> Ремонт компьютеров и ноутбуков
Ремонт двух ноутбуков	OK	Компьютерная помощь -> Ремонт компьютеров и ноутбуков
Ремонт системы охлаждения на ноутбуке	OK	Компьютерная помощь -> Ремонт компьютеров и ноутбуков
Ремонт ноутбука MacBook Pro 13	OK	Компьютерная помощь -> Ремонт компьютеров и ноутбуков
Ремонт ноутбука Acer Aspire 9802AWKMi	OK	Компьютерная помощь -> Ремонт компьютеров и ноутбуков
Вернуть ноутбук к жизни	OK	Компьютерная помощь -> Ремонт компьютеров и ноутбуков
Отремонтировать ноутбук Samaung r475	OK	Компьютерная помощь -> Ремонт компьютеров и ноутбуков
Чистка 2-х ноутбуков	OK	Компьютерная помощь -> Ремонт компьютеров и ноутбуков
Ремонт ноутбука HP Pavilion dv6	OK	Компьютерная помощь -> Ремонт компьютеров и ноутбуков
Ремонт ноутбука Sone Vaio VPSIB 3S1R	OK	Компьютерная помощь -> Ремонт компьютеров и ноутбуков
Ремонт ноутбука Asus-X 550	OK	Компьютерная помощь -> Ремонт компьютеров и ноутбуков
Ремонт ноутбука Asus	OK	Компьютерная помощь -> Ремонт компьютеров и ноутбуков
Ремонт ноутбука Lenovo y500	OK	Компьютерная помощь -> Ремонт компьютеров и ноутбуков
Отремонтировать компьютер	OK	Компьютерная помощь -> Ремонт компьютеров и ноутбуков
Ремонт компьютера Depo	OK	Компьютерная помощь -> Ремонт компьютеров и ноутбуков
Подлечить два ноутбука	OK	Компьютерная помощь -> Ремонт компьютеров и ноутбуков
Ремонт ноутбука Lenovo z500	OK	Компьютерная помощь -> Ремонт компьютеров и ноутбуков
Почистить ноутбук	OK	Компьютерная помощь -> Ремонт компьютеров и ноутбуков
Ремонт ноутбука Lenovo 590	OK	Компьютерная помощь -> Ремонт компьютеров и ноутбуков
Почистить ноутбук VAIO VPC-Z	OK	Компьютерная помощь -> Ремонт компьютеров и ноутбуков
Диагностика компьютера	OK	Компьютерная помощь -> Ремонт компьютеров и ноутбуков
Отремонтировать ноутбук	OK	Компьютерная помощь -> Ремонт компьютеров и ноутбуков
Отремонтировать ноутбук Asus K50AF	OK	Компьютерная помощь -> Ремонт компьютеров и ноутбуков
Воскрешение компьютера	OK	Компьютерная помощь -> Ремонт компьютеров и ноутбуков
Прочистить ноутбук	OK	Компьютерная помощь -> Ремонт компьютеров и ноутбуков
Диагностика ноутбука	OK	Компьютерная помощь -> Ремонт компьютеров и ноутбуков
Ремонт ноутбука Acer	OK	Компьютерная помощь -> Ремонт компьютеров и ноутбуков
Починить ноутбуки	OK	Компьютерная помощь -> Ремонт компьютеров и ноутбуков
Заменить разъём питания на ноутбуке	BAD weak-match	Компьютерная помощь -> Ремонт компьютеров и ноутбуков
	Компьютерная помощь -> Ремонт компьютеров и ноутбуков = 0.799	Ремонт цифровой техники = 0.201
	компьютер(1;1.0;ноутбук), замена(1;1.0;замен), запчасти(1;1.0;разь)
Ремонт ноутбука HP Pavilion DV6	OK	Компьютерная помощь -> Ремонт компьютеров и ноутбуков
Починить ноутбук Samsung np300	OK	Компьютерная помощь -> Ремонт компьютеров и ноутбуков
Ремонт ноутбука Toshiba Satellite	OK	Компьютерная помощь -> Ремонт компьютеров и ноутбуков
Помощь для ноутбука	OK	Компьютерная помощь -> Ремонт компьютеров и ноутбуков
Ремонт ноутбук	OK	Компьютерная помощь -> Ремонт компьютеров и ноутбуков
Ремонт ноутбука Асус	OK	Компьютерная помощь -> Ремонт компьютеров и ноутбуков
Отремонтировать ноутбук Asus	OK	Компьютерная помощь -> Ремонт компьютеров и ноутбуков
Ремонт ноутбуков	OK	Компьютерная помощь -> Ремонт компьютеров и ноутбуков
Ремонт ноутбука ASUS X555L	OK	Компьютерная помощь -> Ремонт компьютеров и ноутбуков
Ремонт ноутбука Samsung RV511	OK	Компьютерная помощь -> Ремонт компьютеров и ноутбуков
Почистить ноутбук Toshiba Satellite	OK	Компьютерная помощь -> Ремонт компьютеров и ноутбуков
Ремонт ноутбука Asus U31S	OK	Компьютерная помощь -> Ремонт компьютеров и ноутбуков
Оптимизировать работу монитора и компьютера	BAD weak-match	Компьютерная помощь -> Ремонт компьютеров и ноутбуков
	Компьютерная помощь -> Ремонт компьютеров и ноутбуков = 0.848	Ремонт цифровой техники = 0.137	Фото- и видео-услуги = 0.015
	электроника(1;1.0;монитор), компьютер(1;1.0;компьютер), отладка(1;1.0;оптимизирова), работа(1;1.0;работ)
Ремонт ноутбука Аsus M51T	OK	Компьютерная помощь -> Ремонт компьютеров и ноутбуков
Переустановка windows, настройка компьютера	OK	Компьютерная помощь -> Ремонт компьютеров и ноутбуков



----------------------------------------------------------




----------------------------------------------------------

Ремонт гнезда для наушников	OK	Ремонт цифровой техники -> Аудиотехника и системы
Замена мини-джека у наушников	BAD weak-match	Ремонт цифровой техники -> Аудиотехника и системы
	Ремонт цифровой техники -> Аудиотехника и системы = 0.785	Ремонт цифровой техники = 0.210	Фото- и видео-услуги = 0.004
	замена(1;1.0;зам), аудио(1;1.0;мини-джек), аудио(1;1.0;наушник)
Ремонт наушников Monster Beats gratitude	OK	Ремонт цифровой техники -> Аудиотехника и системы
Отремонтировать наушники Whinston	BAD weak-match	Ремонт цифровой техники -> Аудиотехника и системы
	Ремонт цифровой техники -> Аудиотехника и системы = 0.872	Ремонт цифровой техники = 0.080	Ремонт цифровой техники -> Видео-фото техника = 0.023	Фото- и видео-услуги = 0.017	Бытовой ремонт = 0.008
	ремонт(1;1.0;отремонтирова), аудио(1;1.0;наушник)
Ремонт музыкальных центров Philips	BAD weak-match	Ремонт цифровой техники -> Аудиотехника и системы
	Ремонт цифровой техники -> Аудиотехника и системы = 0.930	Ремонт цифровой техники = 0.070
	производитель электроники(1;0.3;philips), производитель аудио(1;0.3;philips), производитель тв(1;0.3;philips), производитель планшетов(1;0.3;philips), аудио(1;1.0;музыкальн центр), ремонт(1;1.0;ремонт)
Ремонт синтезатора Casio	BAD weak-match	Ремонт цифровой техники -> Аудиотехника и системы
	Ремонт цифровой техники -> Аудиотехника и системы = 0.928	Ремонт цифровой техники -> Видео-фото техника = 0.060	Ремонт мелкой техники = 0.013
	производитель электроники(1;0.3;cas), производитель фото(1;0.3;cas), производитель аудио(1;0.3;cas), производитель планшетов(1;0.3;cas), производитель часов(1;0.3;cas), ремонт(1;1.0;ремонт), аудио(1;1.0;синтезатор)



----------------------------------------------------------




----------------------------------------------------------

Заменить экран 4s черный	BAD weak-match	Ремонт цифровой техники
	Ремонт цифровой техники = 0.742	Ремонт цифровой техники -> Планшеты и телефоны = 0.258
	замена(1;1.0;замен), экран(1;1.0;экра)
Заменить дисплей на LG	BAD weak-match	Ремонт цифровой техники
	Ремонт цифровой техники = 0.818	Ремонт цифровой техники -> Планшеты и телефоны = 0.182
	производитель электроники(1;0.3;lg), производитель тв(1;0.3;lg), производитель планшетов(1;0.3;lg), замена(1;1.0;замен), экран(1;1.0;диспл)
Перенастройка мини АТС Panasonic	OK	Ремонт цифровой техники
Починить портативный сканирующий приёмник Icom IC-R1	BAD weak-match	Ремонт цифровой техники
	Ремонт цифровой техники = 0.794	Ремонт цифровой техники -> Видео-фото техника = 0.139	Ремонт цифровой техники -> Планшеты и телефоны = 0.021	Фото- и видео-услуги = 0.018	Ремонт мелкой техники = 0.015	Бытовой ремонт = 0.012
	электроника(1;1.0;приемник), ремонт(1;1.0;почин)
Починить принтер samsung scx3200	OK	Ремонт цифровой техники
Припаять HDMI-разъем	OK	Ремонт цифровой техники
Поменять дисплей на 5с	OK	Ремонт цифровой техники
	Ремонт цифровой техники = 0.742	Ремонт цифровой техники -> Планшеты и телефоны = 0.258
	замена(1;1.0;поменя), экран(1;1.0;диспл)


----------------------------------------------------------




----------------------------------------------------------

Перенести контакты с iPhone в Gmail и обратно	OK	Компьютерная помощь



----------------------------------------------------------

USB провод для motorola v3	OK	Запчасти для цифровой техники



----------------------------------------------------------

Отремонтировать видеокамеру	OK	Ремонт цифровой техники -> Видео-фото техника
Ремонт объектива Canon	BAD weak-match	Ремонт цифровой техники -> Видео-фото техника
	Ремонт цифровой техники -> Видео-фото техника = 0.881	Бытовой ремонт = 0.039	Ремонт цифровой техники = 0.034	Компьютерная помощь -> Ремонт компьютеров и ноутбуков = 0.029	Ремонт мелкой техники = 0.017
	ремонт(1;1.0;ремонт), производитель фото(1;0.3;canon)
Починить фотоаппарат Panasonic Lumix DMC-LX3	OK	Ремонт цифровой техники -> Видео-фото техника
Отремонтировать фотоаппарат Olympus	OK	Ремонт цифровой техники -> Видео-фото техника
Ремонт фотоаппарата Casio Exilim EX-H5	OK	Ремонт цифровой техники -> Видео-фото техника
Ремонт видеоплеера	OK	Ремонт цифровой техники -> Видео-фото техника
Отремонтировать фотоаппарат Canon 30D	OK	Ремонт цифровой техники -> Видео-фото техника
Снять объектив с фото аппарата Canon EOS 100D	OK	Ремонт цифровой техники -> Видео-фото техника
Ремонт объектива фотоаппарата Сanon efs 17-85	OK	Ремонт цифровой техники -> Видео-фото техника
Ремонт камеры видеонаблюдения	OK	Ремонт цифровой техники -> Видео-фото техника
Ремонт видеоняни Motorola	OK	Ремонт цифровой техники -> Видео-фото техника
Ремонт цифровой камеры Canon 350D	OK	Ремонт цифровой техники -> Видео-фото техника
Отремонтировать фотоаппарат	OK	Ремонт цифровой техники -> Видео-фото техника



----------------------------------------------------------




----------------------------------------------------------

Отремонтировать пластиковое окно	BAD weak-match	Бытовой ремонт
	Бытовой ремонт = 0.940	Фото- и видео-услуги = 0.025	Ремонт мелкой техники = 0.018	Ремонт цифровой техники -> Видео-фото техника = 0.017	Компьютерная помощь -> Ремонт компьютеров и ноутбуков = 0.000
	ремонт(1;1.0;отремонтирова), house_parts(1;1.0;окн)



----------------------------------------------------------

Наручные часы Hablot. Ремонт	OK	Ремонт мелкой техники



----------------------------------------------------------

Творческий подход к созданию ролика про друзей	OK	Фото- и видео-услуги
Нужен фотограф на детское мероприятие	OK	Фото- и видео-услуги
Фотографировать компании Москвы для сми-портала (можно непрофессиональный фотоаппарат, но не iPhone)	OK	Фото- и видео-услуги
Нужен видеооператор со своей камерой	OK	Фото- и видео-услуги
Смонтировать видео на 3 минуты	OK	Фото- и видео-услуги
Необходимо провести фото- и видео съемку! Видео в HD	OK	Фото- и видео-услуги
Необходимо провести фото-видео съёмку	OK	Фото- и видео-услуги
Подобрать шаблон для презентации, отретушировать фото и вставить в презентацию	OK	Фото- и видео-услуги
Сделать проффесиональные фотографии детского клуба	OK	Фото- и видео-услуги
Предметная съемка коробки с укршениями	OK	Фото- и видео-услуги
Фотокоррекция фотографий	OK	Фото- и видео-услуги
Фото и видео съемка регистрации брака	OK	Фото- и видео-услуги
Провести предметную фотосъемку чехлов для iPhone	OK	Фото- и видео-услуги
Сделать фотографии 8 человек	OK	Фото- и видео-услуги
Женюсь! Нужно сфотографировать	OK	Фото- и видео-услуги
Ретушь фотографий для интернет-магазина	OK	Фото- и видео-услуги
Нужно снять видео. Нужно сегодня.	OK	Фото- и видео-услуги
Съемка торговых центров "Баркли Плаза", "Юсупов Двор" и "Тройка"	OK	Фото- и видео-услуги
Смонтировать ролик и наложить на музыку	OK	Фото- и видео-услуги
Необходимо отредактировать старые фото	OK	Фото- и видео-услуги



----------------------------------------------------------

Обучение фотографии	OK	Учеба -> Репетитор / он-лайн обучение
Обучить ребёнка начальным навыкам фотографирования	OK	Учеба -> Репетитор / он-лайн обучение



----------------------------------------------------------

Нужен администратор в группу ВК. Прокат аксессуаров для фотосессии новорожденных - на МАРТ	OK	Работа
Охранник для досмотра сотрудников	OK	Работа
Нужны люди для флешмоба	BAD weak-match	Работа
	Работа = 0.921	Другое = 0.079
	нужно(1;1.0;нужн), человек(1;1.0;люд), для(1;1.0;для)



----------------------------------------------------------




----------------------------------------------------------

Для мам и пап с детьми до 3-х лет (6)	BAD weak-match	Другое
	Другое = 0.943	Работа = 0.042	Фото- и видео-услуги = 0.010	Ремонт цифровой техники = 0.005
	человек(1;1.0;детьм), для(1;1.0;для)
